NO          ./texture/grass.png
SO ./texture/wall.png
WE ./texture/bricks.png
EA ./texture/wood.png
F       220,100,0
C     225,30,0

1111111
1000001
1011101
1000N01
1111111
