    NO          ./texture/grass.png

    SO ./texture/wall.png
    WE ./texture/bricks.png
    EA ./texture/wood.png





F 20,20,20
C 200,200,200


11111111111111111111111
10000000001000
10001110001
10001 10001
10001110001
10000000001000000000000000
100N0000001
1111111111111111111111111111111