   NO		 		 ./texture/grass.png

    SO ./texture/wall.png
    WE	./texture/bricks.png
    	 	 	 			EA		 	 	./texture/wood.png



F			 	 	 			 +20,20,20
C 0,0,      	0


1111111111111111111
1001001001001001001
1001001001001001001
1001001001001001001
1001001000001001001
100000000N000000001
1000011111111000001
1111000000000001111
1000000101010000001
1111111111111111111
                     
1111111111111111111
1111111111111111111
1111111111111111111

