NO ./texture/bricks.png
SO ./texture/grass.png





F 220,100,255

C 225,100,200


WE ./texture/wall.png
EA ./texture/wood.png


1111111
1000001
1010101
1000N01
1111111
