F 0,32,0
C 120,0,16

NO texture/N.png
SO texture/S.png
WE texture/W.png
EA texture/E.png

1111111111111111111
11E0001001001000001
1110000001000001001
1001001001111101111
1001111000001001001
1000000000000001001
1001111111111001001
1111000000000001011
1000000001000000001
1111111111111111111
