NO texture/cobblestone_1.png
SO texture/brick_wall_grey.png
WE texture/brick_wall_yellow.png
EA texture/bricks.png

F 0,32,0
C 120,0,16

 1111111        111111111
110000011      11000000011
110000011     1100000000011
 1100011     110000000000011
  11011      1100000000000011
   101        1100001110000011
   101         100001 100000011
   101111111111100001110000011
   10000000000000000000000011
   1011111111111000000000011
   101         100000000011
   101        110000000011
  11011      110000000001
 1100011     1100000N0001
110000011     11000000001
110000011      1100000001
 1111111        111111111







