NO texture/cobblestone_1.png
SO texture/brick_wall_grey.png
WE texture/brick_wall_yellow.png
EA texture/bricks.png

F 0,32,0
C 120,0,16


11111111111111111111111
10000000001000
10001110001
10001 10001
10001110001
10000000001000000000000000
100N0000001
11111111111
                   
1111111111111111111111111111111