   WE                  texture/brick_wall_yellow.png
NO texture/cobblestone_1.png
          SO texture/brick_wall_grey.png

F               4294967296,                  4294967296,      4294967296

EA texture/bricks.png
                  
C 255, 0,0 ,

11111111111111111
10000000000000001
10000000000000001
1000S000000000001
10000000000000001
11111111111111111
