   WE                  texture/brick_wall_yellow.png
NO texture/cobblestone_1.png
          SO texture/brick_wall_grey.png

F            255, 255 , 0

EA texture/bricks.png
                  
C 0, 0,255


1111111111111
11S000001  1
11000000111110
11111111111
11111111111
