   WE                  texture/brick_wall_yellow.png
NO texture/cobblestone_1.png
          SO texture/brick_wall_grey.png

F               4294967296,                  4294967296,      4294967296

EA texture/bricks.png
                  
C 255, 0,0 ,

   1111111111111
1111000000000001
11S1000000000001  1
10000000000000011110
11110000000000011111111
11110000000000011111111
11111111111111111111111
