NO texture/cobblestone_1.png
SO texture/brick_wall_grey.png
WE texture/brick_wall_yellow.png
EA texture/bricks.png

F 0,32,0
C 120,0,16


      1111111
11111111000001
100000N0011101
1000000001  101
100000000011101
10000000000011
1111111111111