NO texture/cobblestone_1.png
SO texture/brick_wall_grey.png
WE texture/brick_wall_yellow.png
EA texture/bricks.png

F 20,20,20
C 200,200,200

11111
10001
10W01
10001
10001
10001
11W01
10001
10001
10001
10001
10001
11111
