NO texture/cobblestone_1.png
SO texture/brick_wall_grey.png
WE texture/brick_wall_yellow.png
EA texture/bricks.png

F 0,32,0
C 120,0,16





1111111
10000011
1  N  1
11111111